30
——————————————————————————————
|.x..........................|
|............................|
|............................|
|............................|
|............................|
——————————..——————————————————
          ........            
———————————————— .            
|..............| .            
|..............| .            
|.................            
|..............|              
————————————————              
